%%%%%%%%
%P     %
% .%   %
%  %   %
%  %   %
%     G%
%%%%%%%%
