%%%%%%%%%%%%%%%%%%%%
%.................G%
%.%%.%.%%%%%%.%.%%.%
%....%........%....%
%.%%.%.%%%%%%.%.%%.%
%........P.........%
%%%%%%%%%%%%%%%%%%%%
