%%%%%%%%%%%%%%%%%%%%
%.................G%
%.%%.%.%%%%%%.%.%%.%
%.%..%........%..%.%
%.%%.%.%%%%%%.%.%%.%
%........P.........%
%%%%%%%%%%%%%%%%%%%%
