%%%%%%%
%P....%
%.%%%.%
%.%...%
%.%%%.%
%....G%
%%%%%%%
