%%%%%%%
%PG   %
%.%%% %
%.%.  %
%.%%% %
%     %
%%%%%%%
