%%%%%%%%%%%%%%%%%%%%
%.................G%
%.%%...%%%%%%...%%.%
%.%..%........%..%.%
%.%%.%.%%%%%%.%.%%.%
%........P.........%
%%%%%%%%%%%%%%%%%%%%
